"filename", "language", "C++", "AT&T i386 Assembly", "C", "Shell Script", "Makefile", "comment", "blank", "total"
"c:\ece391_share\work\mp3_group_35\student-distrib\IDT.c", "C", 0, 0, 210, 0, 0, 201, 53, 464
"c:\ece391_share\work\mp3_group_35\student-distrib\IDT.h", "C++", 13, 0, 0, 0, 0, 21, 11, 45
"c:\ece391_share\work\mp3_group_35\student-distrib\Makefile", "Makefile", 0, 0, 0, 0, 24, 7, 11, 42
"c:\ece391_share\work\mp3_group_35\student-distrib\PIT.c", "C", 0, 0, 51, 0, 0, 32, 20, 103
"c:\ece391_share\work\mp3_group_35\student-distrib\PIT.h", "C++", 22, 0, 0, 0, 0, 0, 4, 26
"c:\ece391_share\work\mp3_group_35\student-distrib\boot.S", "AT&T i386 Assembly", 0, 31, 0, 0, 0, 18, 15, 64
"c:\ece391_share\work\mp3_group_35\student-distrib\debug.h", "C++", 23, 0, 0, 0, 0, 3, 8, 34
"c:\ece391_share\work\mp3_group_35\student-distrib\debug.sh", "Shell Script", 0, 0, 0, 18, 0, 1, 4, 23
"c:\ece391_share\work\mp3_group_35\student-distrib\defaultcall.c", "C", 0, 0, 13, 0, 0, 1, 3, 17
"c:\ece391_share\work\mp3_group_35\student-distrib\defaultcall.h", "C++", 8, 0, 0, 0, 0, 0, 4, 12
"c:\ece391_share\work\mp3_group_35\student-distrib\filesystem.c", "C", 0, 0, 111, 0, 0, 117, 33, 261
"c:\ece391_share\work\mp3_group_35\student-distrib\filesystem.h", "C++", 44, 0, 0, 0, 0, 6, 20, 70
"c:\ece391_share\work\mp3_group_35\student-distrib\i8259.c", "C", 0, 0, 52, 0, 0, 34, 17, 103
"c:\ece391_share\work\mp3_group_35\student-distrib\i8259.h", "C++", 23, 0, 0, 0, 0, 16, 10, 49
"c:\ece391_share\work\mp3_group_35\student-distrib\idt_linkage.S", "AT&T i386 Assembly", 0, 43, 0, 0, 0, 5, 6, 54
"c:\ece391_share\work\mp3_group_35\student-distrib\idt_linkage.h", "C++", 38, 0, 0, 0, 0, 2, 6, 46
"c:\ece391_share\work\mp3_group_35\student-distrib\kernel.c", "C", 0, 0, 119, 0, 0, 35, 36, 190
"c:\ece391_share\work\mp3_group_35\student-distrib\keyboard.c", "C", 0, 0, 267, 0, 0, 150, 71, 488
"c:\ece391_share\work\mp3_group_35\student-distrib\keyboard.h", "C++", 32, 0, 0, 0, 0, 129, 29, 190
"c:\ece391_share\work\mp3_group_35\student-distrib\lib.c", "C", 0, 0, 325, 0, 0, 136, 55, 516
"c:\ece391_share\work\mp3_group_35\student-distrib\lib.h", "C", 0, 0, 128, 0, 0, 23, 20, 171
"c:\ece391_share\work\mp3_group_35\student-distrib\multiboot.h", "C++", 51, 0, 0, 0, 0, 10, 12, 73
"c:\ece391_share\work\mp3_group_35\student-distrib\page.c", "C", 0, 0, 107, 0, 0, 51, 28, 186
"c:\ece391_share\work\mp3_group_35\student-distrib\page.h", "C++", 74, 0, 0, 0, 0, 4, 14, 92
"c:\ece391_share\work\mp3_group_35\student-distrib\rtc.c", "C", 0, 0, 54, 0, 0, 59, 11, 124
"c:\ece391_share\work\mp3_group_35\student-distrib\rtc.h", "C++", 22, 0, 0, 0, 0, 1, 10, 33
"c:\ece391_share\work\mp3_group_35\student-distrib\syscall.S", "AT&T i386 Assembly", 0, 40, 0, 0, 0, 9, 18, 67
"c:\ece391_share\work\mp3_group_35\student-distrib\systemcall.c", "C", 0, 0, 311, 0, 0, 195, 76, 582
"c:\ece391_share\work\mp3_group_35\student-distrib\systemcall.h", "C", 0, 0, 86, 0, 0, 16, 26, 128
"c:\ece391_share\work\mp3_group_35\student-distrib\terminal.c", "C", 0, 0, 248, 0, 0, 150, 60, 458
"c:\ece391_share\work\mp3_group_35\student-distrib\terminal.h", "C++", 36, 0, 0, 0, 0, 110, 40, 186
"c:\ece391_share\work\mp3_group_35\student-distrib\tests.c", "C", 0, 0, 282, 0, 0, 173, 66, 521
"c:\ece391_share\work\mp3_group_35\student-distrib\tests.h", "C++", 19, 0, 0, 0, 0, 3, 10, 32
"c:\ece391_share\work\mp3_group_35\student-distrib\types.h", "C", 0, 0, 12, 0, 0, 6, 9, 27
"c:\ece391_share\work\mp3_group_35\student-distrib\x86_desc.S", "AT&T i386 Assembly", 0, 58, 0, 0, 0, 31, 32, 121
"c:\ece391_share\work\mp3_group_35\student-distrib\x86_desc.h", "C", 0, 0, 153, 0, 0, 32, 37, 222
"Total", "-", 405, 172, 2529, 18, 24, 1787, 885, 5820